1111111111111
1001C00000C01
1C00010111001
10C0110E00001
P111111111111